1
X+++++++++++++++++++
-+T+++++++++++++++++
-+++++++++++++++++++
-------++X++++++++++
++++++---------X++++
+++++++++-++++++++++
++++++++T-T+++++++++
++++++++T-T+++++++++
+++++++++MP+++++++++
++++++++++++++++++++
++++++++++++++++++++
+++++++++++++++++++F