2
++++++++++++++++++++
+++T++++++++++++++++
+++--------------+++
+++-++++T+++++++-T++
++T-+P++-----+++-+++
+++-++++-+XXX+++-+++
+++-+++T-+++++++-+++
+++-++++---------+++
+++-+T+++++++++++F++
+++-+++++++++T++++++
+++---------------M+
++++++T+++++++++++++