1
++++++PTMT++++++++++
++++++++-+++++++++++
++++++++-+++++++++++
+++++++T-T++++++++++
++++++++-+++++++++++
X------------------X
++++++TT-TT+++++++++
++++++++-+++++++++++
++++++++-+++++++++++
++++++++-+++++++++++
X------------------X
++++++++TT+++++++++F