3
++++++++++++++++++++
+++T-------------+++
++++-+++++T+++++-+F+
++++-++++++++++T-+++
++M--T+++--------+++
++++T++++-T++++P++++
+++++++++-+++T++++++
+++F++++T--------+++
++++++++++++++++-+++
++++++++++++T+++-+++
++---------------+++
++XXXXXXX+++++++++++