2
++++SSSSS+++++++++++
++++------------++++
+++T-+++++++T++-+SS+
+SS+-++T+++++++-++++
++++M-----++++T-++++
SS+++++++-++P++-+SS+
++++SS++T-+++++-++++
+SS+F++++-+++++-++++
SSS++++++-++++T-++SS
+++++T+++-+++++-+SS+
+++X------T++++X++++
+++++++++++SSSSSS+++