2
++++++++++++++++++++
+++------M-------+++
+++-++++++++++++-+++
+++-++T+++++T+++-+++
+++-+++++F++++++-+++
+++-+T++++++++T+-+++
+++-++++++++++++-+++
+++-++++++++++++-+++
+++-+++++P++++T+-+++
+++-+T++++++++++-+++
+++X++++++++++++X+++
++++++++++++++++++++