2
++++++++++++++++++++
++++------------++++
+++T-+++++++T++-++++
++++-++T+++++++-++++
++++M-----++++T-++++
+++++++++-++P++-++++
++++++++T-+++++-++++
++++F++++-+++++-++++
+++++++++-++++T-++++
+++++T+++-+++++-++++
+++X------T++++X++++
++++++++++++++++++++