1
++++++++++++++++++++
++++++PM-----------X
+++++++++T+-+T++++++
+++++++++T+-+T++++++
+++++++++T+-++++++++
+++++++++++-++++++++
+++++++++++-++++++++
+++++++++++-++++++++
+++++++++++-++++++++
+++++++++++-++++++++
++++++++++T-T+++++++
+++++++++++X++++++++