1
+++++++X++++++++++++
++++++--++++++++++++
++++++--+T++++++++++
++++T+--++++++++++++
++++++--++++++++++++
++++++--++T+++++++++
++++++---------+++++
+++++++++T++++-+++++
++++++++++++++--++++
+++T+++++++++++-++P+
+++M------------++++
++++++++T+++++++T+++