1
++++++++++++++++++++
++M------------+++++
++++++T+++++T+-+++++
++++++++++++++-+++++
+++P+++++------+++++
+++++++++-+++T++++++
+++++++++-++++++++F+
+++++++T+-+T++++++++
+++++++++-++++++++++
++++X----------X++++
++++++++++T+++++++++
++++++++++++++++++++