1
++++++++++++++++++++
++++x++++P+++++x++++
++++-++++++++++-++++
++++-+T++T+++T+-++++
++++------------++++
+++++++++-++++++++++
+++++++T+-+T++++++++
+++++++++-++++++++++
+++++++++-++++++++++
+++++++++M++++++++++
++++++++++++++++++++
++++++++++++++++++++