2
+++++T++++++++++++++
++++++++-------X++++
++-------+++++++++++
++-+++++-++T++++++++
++X++T++-+++++++++++
++++++++-+++++++++++
++++++T+-++++++F++++
++++++++--+T++++++++
+++++++++--+++++++++
+++P+++T++-+T+++++++
++++++++++-+++++++++
+++++++++M-+++++++++