1
++++++++++++++++++++
+++++-----------++++
+++T+-+++++++++-++++
+++++-+T+++++T+-++++
+++++-+++++++++-+X++
+++++M++++P++++---++
+++++-+++++++++-+X++
+++++-+T+++++T+-++++
+++++-+++++++++-++++
+++T+-----------++++
++++++++++++++++++++
++++++++++++++++++++