2
++++++++F+++++++++++
++++++++++++++++++++
++++++++++++++++++T+
+++T+++++++T++++++-X
++++---------------X
++++-T++++++++++++-X
++++-+++++++++++++T+
+F++-+++++++++++++++
++++-+++++++P+++++++
+++T-+++++++++++++++
++++-+++++++++++++++
++++MT+++++++++++++=