3
+++++X++X+++++++++++
++++X----------T++++
+++++X++X+T+++-+++++
+++++T+++++++T-++F++
+++-------++++-+T+++
+++-+T+++-++T+-+++++
+++-++++T------+++++
++T-++++++++T+++++++
+---++++F++++++P++++
+-T++++T+++++T++++++
+--------------M++++
++++++++++T+++++++++