1
++++M+++++++++++F+++
++++-+T+++++++++++++
++T+-+++++++++++++++
++++------++++++++++
+++++++++-++++++++++
++++++T++-++T+++++++
+++++++++-++++++++X+
+++++++++-------++-+
+++P+++T+-+++++-++-+
+++++++++-++T++----+
+++++X----++++++++++
++++++++++++++++++++