3
++++++++++++++++++++
++---------------+++
---++T+++++T+++T-+++
-+X++++F+++++F++-+++
-T++++++P+T++++T-+++
-----++++M-------+++
+++T-++++-+T++++T+++
++++X+++T-++++++++++
+++++++++-+++F++++++
+++T+++++-T+++++T+++
+X----------------X+
+++++++T++++++++++++