1
++++X+++++++++++++++
++++--+++++++++P++++
++T++-++T+++++++++++
+++++-+++++++++++T++
+++++-----------++++
+++++++++++++++-++++
+++++++T+++++++-++++
+++++++++++++++-++++
++++++++++++T++-++++
+++F+++++++++++-++++
+++++++++++++++M++++
++++++++++++++++++++