2
+++X++++++++++++++++
+++-T+++++++++++++++
+++-++++++++++++++++
++T-++++++++++P+++++
F++-+++++F++++++++++
+++-++++++++++++++++
+++-++++++++++++++++
+++-T+++++++++++++++
+++-++++++++++++++++
++T-++++++++++++++++
+++-+++T++++++++++++
+++----M++++++++++++