2
++++++++++++++++++++
+++------T++++++++++
+++-+T++-+++++++++++
+++-+++T-+++++++++++
+++-++++-+T+++++T+++
+++-+T+FM-------++++
+++X+++P+++++++-++++
+++++++++++++T+-++++
++++++----------++++
++++++-+T+++++++++++
++++++X+++++++++++++
++++++++++++++++++++