2
++++++++++++++++++++
++++++++X+++T+++F+++
++X+++++-+++++++++++
++-+++++----------++
++-+T++++++++++++-++
++-+++++++T+++T++-++
++-+++P++++++++++-++
++-+T++++++++++++-++
++-+++++T++++++T+-++
++-++++++++++++++-++
++---------------M++
++++++++++++++++++++