2
SSSSSSSSSSSSSSSSSSSS
S+++++++++++++S+S++S
S+++M---+T+++++++++S
S+++++T---++++F++S+S
S+S+S+++T---T+++S++S
S++S+++++++-++S+S++S
SS++++T+++T-+++++++S
S+++--------+++P+++S
S+++-T+++++T+++++++S
S+++--+++T+++++++++S
SX--------------X++S
SSSSSSSSSSSSSSSSSSSS