2
+++X++++F++++++++X+T
+++-T++++++++++T----
+++-++++++++++++-++-
++T-++++++++++++-++-
X----------------++-
+++T++++++++++++T++-
+++++++++++++++++++-
+++++++P++++++++++T-
F++++++++++++++++++-
+++++++++++++++++++-
++T++++++++++T+++++-
M-------------------