2
++++++++++++++++++++
+++++++++F++++X+++++
+++++T++++++++-+++++
++++++++++++++-+T+++
M-------+++T++-+++++
+++++++-++++++-+++++
++++T++--------+++++
++++++++++++-+++++++
+++++++++T++-++T++++
++P+++++++++-+++++++
+++++++X-----+++++++
++++++++++++++++++++