1
+++++++++M++++++++++
+++++++T+-++++++++++
+++++++++-+T+++P++++
+++++++++-++++++++++
++++++T+--++T+++++++
++++++++-+++++++++++
+++------+++++++++++
+++-++++--------X+++
+++-+T++++++++++++++
+++X+++++++++T++++++
++++++++F+++++++++++
++++++++++++++++++++