1
++++++++++++++++++++
++++++++++++++++++++
++++M++++P++++++++++
++T+-+++++++++++++++
++++-++++++++X++++++
++++-+T++++T+-++++++
++++-++++++++-++++++
++++----------++++++
++++++++++++++++++++
++++++++++++++++++++
++++++++++++++++++++
++++++++++++++++++++