1
+++SSS++SSS+SSSS+SSS
+S+++++SSS+++++SSSS+
SS++M++++P+++++++SS+
S+T+-++S+++++++++SSS
++++-++++++++X++++SS
+S++-+T++++T+-++S++S
++++-++++++++-+++SSS
++++----------++S+++
+S+++++S++++++++++SS
++++S++++++S+S++++++
+++++++++SSSSSS++SSS
++SSS++++++++++SSSSS