3
++++++++++++++++++++
+++------M-------+++
+++-+++T+++++T++-+++
+++-T++++++T++++-+++
+++-----+++------+++
++++T++-+F+-T+++++++
+++P+++-+++--+++++++
++++++T-++T+-+++F+++
+++++++-++++-T++++++
+++XX++-++++-+++XX++
+++-----+++T------++
++++++T+++++++++++++