1
+++MP++++++++++++++X
+++-+++++++++T+++++-
+T+-++++++------+++-
+++-++++++-++++-+++-
+++-++++++-++T+-+++-
+++-++++++-++++-+++-
+T+-++++++-+T++-----
+++-++++++-++++++++T
+++-++++++-+++++++++
+++-+T+----+++++++++
+++-+++-++++++++++++
+++-----+++++++++++F