1
++++++++++++++++++++
+++X+++++P++++++++++
+++-++++++++++X+++++
+++-+T++++++T+-+++++
+++-++++T+++++-+++++
+++------------+++++
+++++++++-++++++++++
+++++++T+-+T++++++++
+++++++++-++++++++++
+++++++++-+++++F++++
+++++++T+-++++++++++
+++++++++M++++++++++