3
++++++++++++++++++++
+++M-----------+++++
++++++++++++++-+++++
++F++T+++T++T+-+++++
++++++++++++++-+++++
+++++----------++T++
+++++-++++++++++++++
+++++-+T++++T++++P++
+++++-++++++++++++++
+++++----------x++++
++++++++++++++++++++
++++++++++++++++++++