2
SSSSSSS++SS+++SS+SSS
SSF++++++++M----+++S
++++++SS++++++T-++SS
S+-------++++++-+++S
++-+TS++-T++P++-++SS
++-+++++-+++++T-+++S
S+-+++++-++SS++-+SS+
++-+++++-+S++++-S+S+
+X-X+++T--------+++S
+X-X+++++SS+++T++S++
++X+++SSSS+++S++++SS
SS++SSS+++++SSSSSSSS