1
XX++++++++++++++++++
--++++++++++++++++++
--++++++++++++++++++
T-++++++++++++++++++
+-+++++++T++++++++++
+-----------------++
+++++++P++++++++T-++
+++++++++++++++++-++
++----------------T+
++-T++++++++++++++++
++-++++++++++++T++++
++-------------M++++