1
++++++++++++++++++++
++++++++++++++++++++
++++++++++++++++++++
+++++++++T+T++++++++
P++++++-------++++++
M-------+T+T+------X
++++++++++++++++++++
++++++++++++++++++++
++++++++++++++++++++
++++++++++++++++++++
++++++++++++++++++++
+++++++++++++++++++F