1
+++++++++++++++++++F
++++++++++++++++++++
++++++++++++++++++++
++++++++++TT++++++++
-----M--------X+++++
-++++P++TT+-++++++++
-++++++++++-++++++++
-++++++++++-++++++++
-T+++F+++++-++++++++
-T+++++++++--+TT++++
-+++++++++++--------
X++++++++++++++++++X
