1
++++++++++++++++++++
++++F+++++++++++++M+
++++++++-X++++++T+-+
++++++T+-+++++++++-+
++++++++-+++++++++-+
++++++++-+T+++++T+-+
++++++++-+++++++++-+
++++++++-----------+
+++P++++++-++T++++++
+++++++T++-++++++T++
+++X-------+++++++++
++++++++++++++++++++