1
++++++++++++++++++++
++++++++++++++++++++
+++F+++P++++F+++++++
+++++++M++++++++++++
++++++T-T+++++++++++
+++++++-++++++++++++
++--------------+-++
++-+-+T+-+T+-T+-+-++
++-+-+++-+++-++-+-++
++-+-+++-+++-++-+-++
++-+-+++-+++-++-+-++
++X+X+++X+++X++X+X++