1
-----X++++++++++F+++
-+++++++++++++++++++
-+++++++++++++++++++
-++++++++++-----X+++
-T+++++++++-++++++++
-T+++++++++-++++++++
-T+++++++++-T+++++++
-++++++++++-T+++++++
-++++++++++-T+++++++
-++++++++++-++++++++
-PT++++++++-++++++++
M-----------++++++++
