1
++++++++++++++++++++
X-----+++----------X
+++++-+++-++++++++++
+++++-++T-T+++++++++
++F++-++T-T+P+F+++++
+++++----M--++++++++
+++++++TT-+-TT++++++
+++++++++-+-++++++++
X---------+--------X
++++++++++++++++++++
++++++++++++++++++++
++++++++++++++++++++
