2
+++++++++++++++++++F
---------------+++++
-+++T++++T++++-+++++
X+++++++++++++-+++++
+++++++F++++++-+++++
M--------------T++++
+P+++++T++++++-+++++
X+++++++++++++-+++++
-T+++++++++++T-+++++
---------------+++++
++++++++++++++++++++
++++++++++++++++++++