2
X++++++++X+++++++++X
-T+++++++-+T++++++T-
-++++++T+-+++++++++-
-++++++++-++--------
-------+T-+++++T++++
++T+++-++-++--------
-------++-++++++T++-
-++++++++-++--------
--------+-T+-+++P+++
+T+++++-+-++--------
+++++++----+++++++T-
+++++F++TM----------