2
SSSSSSS++SSSS++++SSS
SSS+++++S+++++SS+++S
S++++P++---------T++
S+++T+++-++T++++-X+S
+++------S+++S++-X++
++T-++++-+++F++T-X++
+++-+T++-+++++++-X++
S++-++++---------+++
SS+-+SS+++T+++++++++
+++M+++S++++++++++SS
SSS++SS++++SSSSSSSSS
++++SSSSSSSSSSSSSSSS