1
+++++F+F+F++++++++++
++++++++++++++++++++
++++++++++++++++++++
++++++++++++++++++++
++++++++++++++++++++
X------------------X
++++++++T++-+T++++++
+++++++++++----X++++
+++++++++++-++++++++
++++++++++T-T+++++++
++++++++++T-T+++++++
+++++++++++MP+++++++
