1
SSSSS++++SSSSSSSSSSS
SSS++-----------++SS
+++T+-++++SS+++-+++S
SS+++-+T+++++T+-++SS
S++++-+++++SS++-+X++
S++++M++++P++++---+S
SSS++-++SS+++++-+X++
SS++S-+T+++++T+-+++S
+++++-++++SSS++-++SS
+++T+-----------+SS+
SS++++SS++++SSSS++SS
SSSSS++SSSS++++SSSSS