1
--------X+++++++++++
-++T++++++++++++F+++
-++++T+++++++T++++++
-+++++++++++++++++++
-------------------M
-+++++++++++++++++++
-+T+++++T+++++T+++++
-+++++++++++++++++++
-+++++++++++++++++++
-+T++++++++++++P++++
-+++++T+++++++++++++
--------X+++++++++++