3
++++++++++++++++++++
++++T+--------X+++++
++++++-+T+++++++++++
++++++-+++++++++F+++
+++T++--------M+++++
++++++-+++++++++++++
++++++-+T+++++++P+++
++++++-+++++++++++++
++++T+---------X++++
++++++++++++++++++++
+++++++++T++++++++++
++++++++++++++++++++