3
++++++++++++++++++++
++++++++++++++T----+
++++--------+++-+T-+
+F++-T+++T+-+F+-++-+
++++-++P++T-+++-+T-+
++++-++M----+++-++-+
++++-T+++T+++T+-++-+
++++------------+T-+
++++++T++++++T++++-+
+++++XXXXXX++++++T-+
+++++--------------+
++++++++++++++++++++