2
++++++++++++++++++++
X+++++++++++++++++++
-T++++++++++++++++++
----------++T+++++++
-+++++T++---++++++++
-+++++P++++-+++++T+F
-T++++++++T--------M
X++++++++++++++T++++
++++++++++++++++++++
++++++++++++++++++++
++++++++++++++++++++
++++++++++++++++++++