1
++++++++++++++++++++
++F+++T+++++++T+++++
+++++++++----------X
+++-------++++++++++
+++-++++++++++++++++
+++-+++++++T++++++++
+++-++T+++++++++++++
+++-++++++++++++++++
+++-++T+++++++++++++
+++-+++++++++++P++++
+++M++++++++++++++++
++++++++++++++++++++