1
++++++++++++++++++++
++++++++++++++++++++
++++++++++++++++++++
X-++++++++++++++++++
X-++++++TT++++++++-X
X------------------X
X-+++TT++-++TT++++-X
X-+++++++-++++++++++
+++++++++-++++++++++
++++++F+TMT+F+++++++
+++++++++P++++++++++
++++++++++++++++++++
