2
+++++x++++++++++++++
++++X----++++-----++
++++++++-T+++-+T+-++
+++X++++------+++-++
+++-+++T+++++++++-++
++T-------++P++++-++
++++++++T-+++++++-++
+++-------+++++T+-++
++T-++++++++------++
+++-+++T++++-+T+++++
+++M---------+++F+++
++++++++++++++++++++