2
+++++++++X++++++++++
++X++++++-++++++X+++
++-+++++T-++++++-+++
++--+T+++-+T+++--+++
+++-------------+T++
++++T++++-++++++++++
+++++++T+-+T++++++++
++M++++++-++++++++++
+T-+++F++-+++++P++++
++-++T+++-+T++++++++
++--------++++++++++
++++++++++++++++++++