2
++++++++++++++++++++
++++++++++++++++++++
++++M---+T++++++++++
++++++T---++++F+++++
++++++++T---T+++++++
+++++++++++-++++++++
++++++T+++T-++++++++
++++--------+++P++++
++++-T+++++T++++++++
++++--+++T++++++++++
+X--------------X+++
++++++++++++++++++++