1
+++++X++++++++++++++
+++++-++++++++++++++
+++++-++T+++++++P+++
+++++----+++++++++++
++++++++-+++++++++++
++++T+++-++T+++++++
++++++++-+++++++++++
++++++++-----+++++++
++++++++++++-++++T++
++++F++++T++-+++++++
++++++++++++-+++++++
++++++++++++M+++++++