2
+++++++++++++X++++++
++++++++T++++-++++++
++++----------++++++
++++-+++++++T+++F+++
++++-++T++++++++++++
++++------------M+++
++++P++++++++T+-++++
+++++++T+++++++-++++
++++X--++++++T+-++++
++++++----------++++
+++++++++T++++++++++
++++++++++++++++++++