3
SSSSSSSSSSSS++++++++
SSSSSSS+++++++T----+
++++--------+++-+T-+
+F++-T+++T+-+F+-++-+
++++-++P++T-+++-+T-+
SS++-++M----+++-++-+
++++-T+++T+++T+-++-+
SSSS------------+T-+
SSS+++T++++++T++++-+
SSSS+XXXXXX++++++T-+
+++++--------------+
+++SSSSSS+++++++++++