1
++++++++++++++++++++
++++++++++++++++++++
++++X-------+T++++++
+++++++++T+-++++++++
+++++++++++-++++++++
+++++++++++-++++++++
+++++++++++-+T++++++
++T+--------++++++++
++++-++++++++++++P++
++++-+T+++++++++++++
++++-------------M++
+++++++++++++T++++++