3
+++++X++X+++++++++++
++++X----------T++++
+SS++X++X+T+++-++SS+
+SS++T+++++++T-++F++
SS+-------++++-+T+++
+++-+T+++-++T+-+++++
SS+-++++T------+++SS
++T-++++++++T+++++++
+---++++F++++++P+SS+
+-T++++T+++++T+++SS+
+--------------M++SS
+++SS+++++T+++++++++