2
X--+++++++T--------X
++-+++++----++++++++
++-+++++-+++++++++++
++-------++++++F++++
++++T+++-++T++++++++
++++++++-----------X
++++++++-+++T+++++++
++++++++-+++++++++++
+++++++T-+++++++++++
++++++++-+++++++++++
++++++++-+++++++++++
++++++++MT++++++++++