1
++++++++++++++++++++
+++++++++T++++++++++
++++++X-----------X+
+++++++++++++-++++++
++F++++++++T+-+T++++
+++++++++++++-++++++
++++++++P++++-+T++++
+++++++++++++-++++++
+++M++T++++++-++++++
+++-+++++++T+-++++++
+++-----------++++++
++++++++++++++++++++