3
X+T+++X+T+X++T++X+++
-----------------++
+++++++T-+++++++++++
++++++++-+++++++++++
++++++++-+++++++++++
++++++++-T+++++++++
++++++++-+++++++++++
+++++++T-+++++++++++
++++++++-++++F++++++
++++++++-+++++++++++
+++++++T-+++++++++++
F+++++++M++++++P++++