3
++++++++++++++++++++
++X------------+-+++
++++++++++++++++-+++
++++T++++T+++T++-+++
++++++++++++++++-+++
+++F++++M--------+T+
++++++++P++T++++-+++
++++++++++++++++-+++
+++++T+++T+++T++-+++
++++++++++++++++-+++
+++X-------------+++
++++++++++++++++++++