1
++++++++++++++++++++
++++++++++++++++++++
++++++++++++++++++++
+++++++TT+++++++++++
++X--------------X++
+++++++++-++++++++++
+++F++TT+MP+TT++F+++
+++++++++-++++++++++
++X--------------X++
++++++++TT++++++++++
++++++++++++++++++++
++++++++++++++++++++