2
+++++++++++------+++
+++X--------++++-+++
+++++++++++-++T+-+++
++F+++++T++-++++X+++
+++++++++++-++++++++
+++++T+++++-++T+++++
+++++-------++++++++
+++++-++++++++++++++
+++T+-++++T+++++++++
+++++-++++++++++P+++
+++++----M++++++++++
++++++++++++++++++++