2
++++++++++++++++++++
+++T+++++++T++++++++
+++--------------+++
+++-++++T+++++++-T++
++T-+P++-----T++-+++
+++-++++-+XXX+++-+++
+++-+++T-++++++T-+++
+++-++++---------+++
+++-+T+++++++++++F++
+++-+++++++++T++++++
+++---------------M+
++++++T+++++++T+++++