2
++++++++++++++T+++++
++++++F++++M----++++
+++++++T++++++T-++++
++-------++++++-++++
++-+T+++-T++P++-++++
++-+++F+-+++++T-++++
++-+++++-++++++-++++
++-+T+++-+T++++-T+++
++-++++T--------++++
+X-X++++++++++T+++++
++X+++++++++++++++++
++++++++++++++++++++