3
X------------------X
+++T+++++-+++++++T++
X------------------X
++++++T++-+T++++++++
+++++++++-++++++++++
++++++++T-++++++++++
+++++++++-T+++++++++
+++++++++-+++++++++F
++++++++T-++++++++++
++++P++++MT+++++++++
+++++++++F++++++++++
++++++++++++++++++++