1
++X+++++++++++++++++
++-+++F++++++++M++++
++-+++++++++T++-++++
++-+T++++++++++-++++
++-++++++++++++-++++
++--------------++++
+++++++-++++++++++T+
+++++++-++T+++++++++
+++++++-++++++++++++
++++T++-++++++++++++
+++++++-+++++++P++++
+++++++X++++++++++++