3
++++++P+++T+++++++++
++++++++++++++++++++
+++M------------++++
+++++++++++++++-++++
++++++T+++++T++-++++
+++++++++++++++-++++
++++F+++++++T++-+T++
+++++++++T+++++-++++
+++++++++++++++-++++
++++X-----------++++
++++++T+++++++++++++
++++++++++++++++++++