2
X--------+++T------X
+++++T++------++T+++
++++++++-++++-++++++
++++++++--T++-++++++
+++++++++-+++-++T+++
T++++----M+++-------
---++-++++T++++++++-
-+-T+-+++-----------
-+----+++-T++++P++++
-++++++++--+++++++++
-T++++++++----------
X+++++++++++++++T++X