1
++++++++++++++++++++
+F++------------X++
++++-++T++++++++++++
++++-+++++++++++++++
+T++-+++++++++T+++++
++++--M+++++++++++++
++++++----------++++
++++T++++++++++-++++
+++P++++++++T++-++++
+++++++++++++++-++++
++++++++++X-----+T++
++++++++++++++++++++