1
++++++++++++++++++++
++++++++++T+++++++++
+++T-----------M++++
++++-+++++++++++++++
++++-+++++++T+++++++
++++--------+++++++
+++++++++++-++++++++
++++P++++T+-++++++++
+++++++++++-++++++++
++++++++++X-++++++++
++++++++++++++++++++
++++++++++++++++++++