1
XXXXXXXXXXXXXXXXXXXX
--------------------
+++++++TT-++++++++++
+++++++++-T+++++++++
+++++++++-T+++++++++
++++++++T-++++++++++
+F++++++T-+++++++F++
+++++++++-T+++++++++
+++++++++-T+++++++++
++++++++T-++++++++++
++++++++T-++++++++++
++++++++TMP+++++++++
