1
+++++P++++++++++++++
++++++++++++++++++++
++++-----------M++++
++++-+++T++++T+++++
++++-+++++++++++++++
+T++-+T+++++++++F+++
++++-+++++++++++++++
++++-+T+++++++++++++
++++-++++++T++++++++
++++----------X+++++
++T+++++++++++++++++
++++++++++++++++++++