3
X-+++++++++++++++++F
X-++++++++++++++++++
X-T+++++++++++++++++
X-++++++++++++++++++
X--++++++T+++++T++++
++---------------+++
++++++++++++++++-+++
++T--------------+F+
+++-++++++++++++++++
+++-T+++++++T+++++++
+++-----------------
+++++++T++++P+++++TM