1
M-----------------++
P+++++++TT+++++++-T+
+++++++++++++++++-T+
++++++++++++++++--++
++++++++---------+++
++++++++-+++++++++++
+++++++T-T++++++++++
+++++++T-T++++++++++
+++++++T-T++++++++++
++++++++--++++++++++
+---------++++++++++
F++XXXXXXX++++++++++
