3
SSSSSSSSSSSSSSSSSSSS
+++------M-------+++
S++-+++T+++++T++-+SS
S++-T++++++T++++-+++
+++-----+++------+++
++++T++-+F+-T++SSSSS
+++P+++-+++--+++++++
SSSS++T-++T+-+++F+SS
SSS++++-++++-T++++++
+++XX++-++++-+++XX++
+++-----+++T------++
SSSSS+T+++++++++++++