2
+SSSSS+SSX++SS++SSSS
SSX++SSS+-X++S++X+++
S+-+++++S-++S+++-+SS
S+--+T+++-+T+++--++S
+++-------------+T++
S+++T++++-+++++++SSS
SS++SS+++-+SS++SSS++
++M++++++-++++++++SS
+T-+++F++-+++++P+++S
++-++S+++-+T++++++S+
S+--------+++++SSSSS
SSSS+SSSS+++SSSSSSSS