2
++++++++++++++++++++
++M--------------+++
++++++++++++++++-+++
+P++T+++T+++++T+-+++
++++++++++++++++-+++
++++X------------+++
++++++++++++++++-+++
++++++++T+++++T+-+++
++++F+++++++++++-+++
++++++++++++T+++-+++
+++++++++X-------+++
++++++++++++++++++++