1
X+++++++++++++++++++
-----------------+++
++++++++++++++++-+++
++++++++++++++++-T++
++++++++++++++++-T++
+++++T++++++++++-++P
F+++---------------M
++++-++++++++T+T++T-
++++-++++++++++++++-
++++-T+++++++T+++++-
++++-++++++++-------
++++X++++++++X++++++
