3
XXXXXXXXXXXXXXXXXXXX
--------------------
+++++++TT-++++++++++
+SS++++++-T+++++++++
+SS++++++-T+++++++++
+SS+++++T-++++++++++
++++++F+T-++F+++++++
+++++++++-T+++++++++
+++++++++-T+++++++++
++++++++T-++++++++++
++++++++T-++++++++++
++++++++TMP+++++++++
