1
++++++++++++++++++++
+++++++++----------X
++F++++++-++++++++++
+++++++++-++T++++T++
++T+++T++-++++++++++
+++++++++-++++++++++
M---------++++++++++
+++++++++-++++++++++
++++++T++-++T++++T++
+++++++++-++++++++++
++P++++++----------X
++++++++++++++++++++