3
X+++++++++++++S+++++
-T++++S++++S++++++++
-+++S++++++++P++++++
-+++++S++++++++S++++
-T+++++++++++++++++T
-------------------M
++++T++++++T++++++++
++++++++++++++++++++
++S++++F++++++++S+++
++++++++++++++S+++++
+++++++++S++++++++++
++++++++++++++++++++