2
++++++++++++++T+++++
++F++++++++++++--M++
+++++++T+++++++-++++
++-------++++++-++++
++-+T+++-T++P++-++++
++-+++++-+++++T-++++
++-+++++-++++++-++++
++-+T+++-+T++++-++++
++-+++++--------++++
+X-X++++++++++T+++++
++X+++++++++++++++++
++++++++++++++++++++