1
++++++++T++++++----X
+++++++++-------+++T
+++++++++-++++++++++
+++++++P+-++++++++++
++++T++++----------+
M-----+++++++++T++-+
+++++-++++++++++++-+
----+-T+++++++++++-+
-++-+--------------+
--+---++++++++++++++
+-++++T++++++++++++T
T------------------X