1
++++++++X+++++++++++
+++++++T-+++++++++++
+++P++++-T++++++++++
++++++++-+++++++++++
++++++++-+++++++++++
++-------+++++++++++
++-++++++T++++++++++
++------++++++++++++
+++++++-++++++++++++
+++++++-+T++++++++++
+M------++++++++++++
++++++++++++++++++++