1
+++++++++F++++++++++
++++++++++++++++++++
++++++++X+++++++++++
++++++++-+++++++++++
+++++++T-T++++++++++
++++++++-+++++++++++
--------M+P+++++++++
-+++++++TT++++++++++
-+++++++++++++++++++
-T++++++++++++++++++
-+++++++++++++++++++
X+++++++++++++++++++