2
SS+++SSS+++++SSSSSSS
SSS------T++++++SSSS
S++-+T++-+++SSS+++SS
SS+-+++S-++++++++++S
+++-++++-+T++S++S+++
S++-+S++M-------+SS+
+++X+++P+++++++-++SS
++SSS++++FSS+T+-S++S
S+++++----------S+SS
++++++-+T+++SS++++++
SS++++X++++++++SSSSS
SSSSSS+++++SSSSSSSSS