1
++++++++++++++++++++
++++T++++T+++++++X++
+++++++++++++++T+-++
+M----------+++++-++
+++++++++++-+++++-++
++++++P++T+-+++T+-++
+++++++++++-+++++-++
+++++++++++-------++
++++F+++++++T+-+++++
++++++++++++++-+++++
++++++++X------+T+++
++++++++++++++++++++