1
S++SSS+++++++SSSSSSS
+SS+++++++T++++++SSS
SS+T-----------M++++
+SS+-+++S+++++++++SS
SS++-++SSS++T++S+++S
++++--------++++++S+
+S+++++++++-++SS++++
++++P++++T+-++++SSSS
+++++++++++-+++SSS++
SSSS++++++X-++SS++SS
++SSS+++SS++SSSS+S++
SSS+SSS+++SSSS+++SS+