3
++++++++++++++++++++
+++-----------X+++++
+++-++T++++T++++++++
+++-++++++++++++++++
+++-------M+++++++++
++++++++++-+++P+++++
++++T+++T+-+T+++++++
++++++++++-+++++++++
++++++++T+-----X++++
+++F++++++++++++++++
++++++++++++++++++++
++++++++++++++++++++