2
++++++++++++++++++++
++++++++++++++++++++
+++++P++---------T++
++++T+++-++T++++-+++
+++------+++++++-X++
++T-++++-+++F++T-X++
+++-+T++-+++++++-X++
+++-++++---------+++
+++-++++++T+++++++++
+++M++++++++++++++++
++++++++++++++++++++
++++++++++++++++++++