1
+++++++++++++++M++++
++++++T++-------++++
+++++++++-++++++++++
+++++++++-+T++++++++
+++++++++-++++++++++
++F++++++-++++++P+++
+++++++++-+T++++++++
+++++++++-++++++++++
+++++++++-++++++++++
+++++T+++-+T+++T++++
+++++++++-++++++++++
+++X------------X+++