1
++++++++++++++++++++
++++++++++++++++++++
++++++++X-------++++
+++++++++++T+++-++++
+++++P+++++++T+-++++
+++++++++++-----++++
+++++++++++-++++++++
+++++++++++-+T++++++
++++T++++T+-++++++++
+++++++++++-+++++F++
++M---------+T++++++
++++++++++++++++++++