3
SSSS+++SSSSSS+++++++
+++T-------------SSS
++++-+++++T+++++-+FS
++++-++++++++++T-+SS
F+M--T+++--------+++
++++T++++-T++++P++++
SSS++++++-+++T++++SS
+++F++++T--------+++
S+++SSS+++++++++-+SS
SS+++SS+++++T+++-+++
SS---------------+++
SSXXXXXXX++++SSSSSSS