1
SSSSSSSSSSSSSSSSSSSS
SS++++SSS++S++++SSSS
S+S+X-------+T+++++S
SS+++++++T+-++S+++SS
SSS++++S+++-+S++++++
SS++++SS+++-++++SSSS
S++++++++++-+T++++SS
S+T+--------++S+++++
S+++-+++SSS++++++P+S
SS++-+T+++++++++++SS
+S++-------------M++
+SS+++SS+++++T++SSS+