3
++++++++++++++++++++
+++++T++++++T+++++++
++--------------X+++
++-++++++-++++++++++
++-+T++T+-+T++++++++
++-++++++-++++P+++++
++-+++T++-++++++++++
++-++++++-++++++++++
++-++++++X++++++++++
++-+T++++++++++F++++
++M+++++++++++++++++
++++++++++++++++++++