1
+++M---------+++++++
++++++++T+++-+T+++++
+++P++++++++-+++++++
++++++++++++-++F++++
++++++++++T+-+++++++
++++T+++++++-+++++++
+++++--------+T+++++
+++T+-++++++++++++++
+++++-----X+++++++++
+++++-+T++++++++++++
+++++X++++++++++++++
++++++++++++++++++++