2
SS+++++++++++SSSSSSS
SSS------T++++++SSSS
S++-+T++-+++SSS+++SS
SS+-+++T-++++++++++S
+++-++++-+T++S++T+++
S++-+T++M-------++++
+++X+++P+++++++-++SS
++SSS++++F+++T+-+++S
S+++++----------++SS
++++++-+T+++++++++++
SS++++X++++++++SSSSS
SSSSSS+++++SSSSSSSSS