1
++X+++++++++++++++++
++-++++++++++++F++++
++-+T+++++++++++++++
++-+++++++++++++++++
++-+T++++++T++++++++
++-+++++++++++++++++
++---------+++++++++
++++++++++-+++++++++
++T++++T++-+++++++++
++++++++++-+++++++++
++P+++++++-+++++++++
+++++++T++-------M++