2
++++++++++++++++++++
++++++++++++++++++++
++++M---++++++++++++
++++++T---++++F+++++
+++++++++---T+++++++
+++++++++++-++++++++
++++++T+++T-++++++++
++++--------+++P++++
++++-T++++++++++++++
++++--+++T++++++++++
+X-----------X++++++
++++++++++++++++++++