3
++++M+++++++++++++++
++T+-+++P+++X+++++++
++++-+++++++-+++++++
++++-+T+++++-+T+++++
++++-+++++++-+++++++
++++---------+++++++
++T+++++++++-+T+++++
++++++++++T+-+++++++
++++++++++++-+++++++
+++F++++++++-+++++++
++++++++++++X+++++++
++++++++++++++++++++