2
X-----T+++++T------X
+++++-+++++++-++++++
++++T-+++X+++-++++++
+++++---------T+++++
++++++++-T++++++++++
++++++++-+++++++++++
+++++++T-+++++++++++
+++F++++-+++++++F+++
++++++++-+++++++++++
++++++++-+++++++++++
++++++++-T++++++++++
+++++++PM+++++++++++