2
+++++SS++++++X++++SS
SSS+++++T++++-+++SSS
++++----------++++++
S+++-+++++++T+++F+++
++S+-++T+SS+++++++++
++S+------------M++S
++++P++++++++T+-++++
++++S++T+++++++-SS++
++++X--++++++T+-++++
++++++----------++++
SS+++++++T++++++++++
++++S++++SSS++++++SS