3
S+++++++++++++++SSS+
++---------------+++
---++T+++++T+++T-SSS
-+X+SS+F+++++F++-+++
-T+SSS++P+T++++T-+++
-----+SS+M-------SSS
+++T-++++-+T++++T+++
SS++X+++T-++++++SS++
SS++SSS++-+++F++++SS
+++T+++++-T+++++T+++
+X----------------X+
+++++++T+++++SSSSS++