1
X-----------++++++++
+++++++++++-++++++++
++----------++++++++
++-+++++++++++++++++
---+---++T+++T+++++P
-+++-+-------------M
-+++-+-++++++T++++T+
-+++-+-T++++++++++++
-----+-T++++++++++++
++++++-+++++++++++++
++++++-+++++++++++++
++++++-------------X