2
++++++++++++++++++++
++++++P+++++++X+++++
++++++++++++++-+++++
++++++++T+++T+-++T++
++++++++++++++-+++++
+++M-----------+++++
++++++++++++++-+++++
+++++++T++++T+-+++++
++++++++++++++-+T+++
++++++++++++++-+++++
++++F+++++++++X+++++
++++++++++++++++++++