1
++++++++++++++++++++
+++++X+++++T+++F++++
+++T+-++++++++++++++
+++++------+++++++++
++++++T+++-++T++++++
++++++++++-++++----+
++++++----------++-+
+++T++-++++T++++T+-+
++++++-+++++++++++-+
++++++M+++++P+++++-+
++++++++++++++++++X+
++++++++++++++++++++