2
++++++++++++++++++++
++++P++++++++++++X++
+++++++++++T+++++-++
+++++T+++++++++++-++
+++++++-----------++
+++++++-+++++++T++++
+++++++-++T+++++++++
+++++T+-++++++++++++
+++++++-+++++++F++++
+++M----++T+++++++++
++++++++++++++++++++
++++++++++++++++++++