1
+++++++++++X++++++++
++++F++++++-++++F+++
+++++++++++-++++++++
+++++++++++-++++++++
------------++++++++
-+++++T++++-++++++++
-++++++++++-+++T++++
-++++++++++--------X
-T++++++++++++++++++
-T++++++++++++++++++
-+++++++++++++++++F+
MP++++++++++++++++++