2
SSSSSS++++SSS+++++++
++++X----++++-----++
++++++++-T+++-+T+-++
+++X++++------+++-++
+++-+++T+++++++++-++
++T-------++P++++-++
+++SSS++T-+SSS+++-SS
+++-------++SS+T+-++
++T-++++++++------++
SSS-+++T++++-+T+++++
+++M---------+++F+++
+++++++++++++SSSSSSS