1
++++++++XXX+F+++++++
+++++++T---+++++++++
+F+++++++--T++++++++
++++++++T--T++++++++
+++++---+--+++++++++
+++++-+----+++++++++
+++++-T+++T+++++++++
+++++-----++++++++++
+++++++++-++++++++++
+++++++T+-++++++++++
+++++++++-T++++F++++
+++++++++M++++++++++