3
++++++++++++++++++++
++X-------++++++++++
+++++++++-+T++++++++
+++++++T+-++++++++++
+++P+++++-+T++++++++
+++++++++-++++++++++
+++++++++M++++++++++
+++++++++-++++++++++
+++++++T+-+T++++++++
++F++++++-++++T+++++
+++++++++-------X+++
++++++++++++++++++++