1
SSSSSSSS+++SSS+++SSS
++++X+S+SS++S++X++++
SS++-++++++SS++-+++S
S+++-+T++T+S+T+-+SSS
++++------------++SS
S++++P+++-+++SS++++S
SSS++++T+-+T++++SSSS
S++SS++++-+++S++++SS
SS++SS++T-++T+++++++
+++++++++--------M++
SSS+++++++SSS+++++SS
SSSSSSSS++++++SSSSSS