1
+++++++++++++++++++M
+++F+++++++++++++++-
+++++++++++++++++++-
++++++++++++++++T++-
+++++++++++++++++++-
+++++++++X+++++++++-
++P++++T+-+++++T+++-
+++++++++-+++++++++-
+++++++++-+++++++++-
+++++T+++-+++T+++++-
+++++++++-+++++++++-
X-------------------