2
++----------+++++++S
++-+T++++T+-++++SS++
++-++-------++++++SS
++-++-++T-++++F+++++
++-T+-+++-+T++++++++
++X++X++T-++++++M-++
+++++++++-+++++T+-++
+++++P+++-T++++++-++
+++++++++---------++
S++SS++++++++T++++++
S+++SS++++++++++++++
SSSSSSSSSSSSSSSSSSSS