2
++----------+++++++
++-+T++++T+-++++++++
++-++-------++++++++
++-++-++T-++++F+++++
++-T+-+++-+T++++++++
++X++X++T-++++++M-++
+++++++++-+++++T+-++
+++++P+++-T++++++-++
+++++++++---------++
+++++++++++++T++++++
++++++++++++++++++++
++++++++++++++++++++