1
+++X++++++++++++++++
+++-++++++++++F+++++
+++-++++++++++++++++
+++-++++++++++++++++
+++-++++++++++++++++
+++-------------++++
+++++TT++-++TT+-++++
+++++++++-+++++-++++
+++++++++-+++++-++++
++++++T++-+T+++-++++
+++++++++-+++++-++++
+++++++++MP++++X++++