1
X-++++F+++++++++++++
X-++++++++++++++++++
X-++++++++++++++++++
X-++++++++++++++++++
X-+++TTTT++++++++++P
X------------------M
X-++++++++TTTT+++++T
X-++++++++++++++++++
X-++++++++++++++++++
X-++++++++++++++++++
X-++++++++++++++++++
X-++++F+++++++++++++
