1
+++++++++++T++-----X
+++++++++T++---+++++
+++++++T+----T++++++
F++++++---++++++++++
+++++T+-++++++++++++
++PM----T++++++++++F
+++++T+---++++++++++
+++++++++-T+++++++++
++++++T++-++++++++++
+++++++T+-+T++++++++
+++++++++--T++++++++
+++++++++T---------X