2
++++++++++++++++++++
+++------T++++++++++
+++-+T++-+++++F+++++
+++-++++-+++++++++++
+++-++++-+T+++++T+++
+++-+T++M-------++++
+++X+++P+++++++-++++
+++++++++++++T+-++++
++++++----------++++
++++++-+T+++++++++++
++++++X+++++++++++++
++++++++++++++++++++