1
++++++++++++++++++++
+++++++++P++++++++++
++++T++++++++++M++++
+X-----++++++++-++++
++++++-++++++++-++++
+++T++-++T+++++-++T+
++++++-++++++++-++++
++++++----------++++
+++T++-+++++++++++++
++++++-++++++T++++++
+X-----+++++++++++++
+++++++++++F++++++++