2
SSSS++SSSS++SS+SSSSS
S++T+++S+++S++SS++SS
+++--------------++S
SS+-+++TS++S++++-S++
++S-+P++-----X++-++S
+++-++++-XXXXX++-+SS
SS+-+SSS-++SS++T-+++
+S+-++++---------+++
SSS-+T+++SS++++++F+S
SS+-+++++++++++++++S
S++---------------M+
SSS+++SS+SSS++T++SSS