1
SSSSSSSSSSSSSSSSSSSS
+++++++++++++++++++S
+++X+++++++++++++++S
+++-+++++++++++++++S
+++-+++++++++++++++S
+++-+T+++++++++++++S
+T+-+++++++++++++++S
+++-++++++++PMT++++S
+++-++++++T++-+++++S
+++-----------+++++S
+++++++++++++++++++S
SSSSSSSSSSSSSSSSSSSS
