1
+X++++++++++++++++X+
+-++++++++++++++++-+
+-++++++++++++++++-+
+------------------+
++++++++T-T+++++++++
++++++++T-T+++++++++
+F++++PM--+++++++F++
+++++++-++++++++++++
+++++T+-++++++++++++
+++++T+-++++TT++++++
--------------------
X++++++++X+++++++++X