3
XXXXXXXXXXXXXXXXXXXX
--------------------
-T++++++F++++++++++T
-++++++++++++T++++++
-----------------T++
+++++F++T+++++++-+++
++---------------T++
++-T++++++++++++++++
++---------------T++
++++++++T+++++++-+++
++++F++++++P++++-+++
++++++++++++++++MT++
