3
+++++++----X++++++++
+++++++-++++++++++++
X-------+T+++++P++++
+++++++-++++++++++++
+++++T+-++++++++++++
+++++++-+T++++++++++
+++++++-++++++++++++
+++++T+--------+T+++
++++++++++++++-+++++
++++F+++++++T+-+++++
++++++++++++++-+++++
+++++++++M-----+++++