2
X+++++++++++++++++++
-T++++++++++++++++++
-++++++++++++P++++++
-+++++++++++++++++++
-T+++++++++++++++++T
-------------------M
++++T++++++T++++++++
++++++++++++++++++++
+++++++F++++++++++++
++++++++++++++++++++
++++++++++++++++++++
++++++++++++++++++++