1
+++++++++X++++++++++
+++++++++-++++++++++
++++++++T-T+++++++++
+++++++++-++++++++++
++++++++T-T+++++++++
X--------M---------X
++++TT++TPT+++++++++
++++++++++++++++++++
++++++++++++++++++++
++++++++++++++++++++
++++++++++++++++++++
++++++++++++++++++++
