2
+++++++++X++++++++++
++X++++++-++++++X+++
++-+++++T-++++++-+++
++--+T+++-+T+++--+++
+++-------------+T++
+++++++++-++++++++++
+++++++T+-+T++++++++
+++++++++-++++++++++
++++F++++-+++++P++++
+++++++++-+T++++++++
+++++++++-M+++++++++
++++++++++++++++++++