1
++X+++++++++++++++++
++-++++++++++X++++++
++-++++++++++-++++++
++-++++++++++-++++++
++-++++++++++-++++++
+T-+----------++++++
+T-+-++TT+++++++++++
++-+-----+++++++++++
++-+++++-+++++++++++
++------MP++++++++++
++++++++TT++++++++++
+++++F++++++++++++++