1
++++++++++++++++++++
M-------++++++++++++
P++T+++-++++++++++++
+++++T+-++++++++++++
+++++++-+++++++++F++
+++++++----+++++++++
++++++T+++-+++++++++
++++++++++-+++++++++
++++++++T+-+++++++++
++++++++++--++++++++
+++++++++++--+++++++
++++++++++T+-------X