1
++++++++++++++++++++
++++++++++++++X-++++
+++++F+++++++T+-++++
+++++++++++++++-++++
+++++++++P+++++-++++
+++++T++++++T++-++++
+++++++++++++++-++++
++M-------------+T++
+++++++++++++++-++++
++++++++++T++++-++++
+++++++X--------+T++
++++++++++++++++++++