1
MP++++-----+++++++++
-------+T+-+++++++++
+-T+++++++---+++++++
+-++++++++++-+++++++
+-++++++++++-+++++++
+-+++++++++T------++
--+++++++++++++++-++
-T++++++++++++++T-++
-++++++++++++++++-++
-++++++++++++++++-++
-+++++++++++++++T---
X++++++++F+++++++++X