1
++++++++++++T+-----X
++++++++++++++-----X
++++++++++++++-++T++
++++++++++++++-+++++
++++++++++++T+-+++++
M---+T++++++T+-+++++
P++---------++-T++++
+++++++++++-++-+++++
+++++++T+++-++-+++++
+++++++++++----+++++
+++++++++++++T++++++
+++++++++++++++++++F