1
F++++++++X++++++++++
+++++++++-++++++++++
+++++++++-++++++++++
+++++++++-+T++++++++
+++++++++-++++++++++
+++++++++----+++++++
++++++++++T+-+++++++
++++++++++++-T++++++
++++++++-----+++++++
++++++++-++T++++++++
++++++++-----++++++P
+++++++++T++---++++M