1
X++++++++F+T+++++++X
--------------------
+++T+++++-++++T+++++
+++++++++-++++++++++
+++++++++-T+++++++++
+++++++++-++++++++++
+++++++T+-++++++++++
++++++----T+++++++++
++++++-+T+++++++++++
-----T------++++++++
-+++-++++++-++++++++
MP++--------+T+++++F
