1
++++++++++++++++++X+
++++++++++++++++++-+
++++++++++++++++++-+
+++++++++++++T++++-+
++++++++++++++++++-+
+P++T++++-------++-+
+M--------+++++-++-+
+++++++++++++++-++-+
+++++++++++++++----+
++++++++++++++++T+++
++++++++++++++++++++
++++++++++++++++++++
