1
++++++++++++++
++++++++|+++++
|||++++++|++++
+++|||++++++++
+|+|+|+++||+++
|+|+|+++++++++
+++++++||+++++
||++||++++++++