1
X++++++++X+F+++++++X
-++++T+++-+++++T+++-
-T+---+++-++++---++-
-++-+-+++-+T++-+-++-
-++-T-+++-+T++-T-++-
----+-+++-++++-+----
+++++-+++-++++-+++++
+++++----------+++++
+++++T++-++T++++++++
++++++++-+++++++++++
+++++++T-T++++++++++
F+++++++MP+++++++++F