1
M----------+++++++++
+P++++++++-+++++++++
++++++++T+-+++++++++
++++++++++-+++++++++
+++++++++--+T+++++++
+++++++++-++++++++++
+++++++++-++++++++++
++++++++--++++++++++
++++++++-+++++++++++
++++++++-+++++++++++
++++++++-----------X
F++++++++++T+++++T++