1
X+++++++++++++++++++
-+++++++++++++++++++
-+++++++++++++++T--X
-++++++++++++++++-++
-T+++----T+++++++-++
------T-M---------+T
T++++++-PT++++++++++
++++++++-+++++++++++
++++++T+-T++++++++++
++++++++-+++++++++++
++++++++-+++++++++++
F+++++++X++++++++++F