1
X+++++++X++F+++++++X
-------+-T+---++++T-
-T+T++------+---+++-
-++++++++++T+++---T-
-T++++T+T++++++++-T-
-++T++--MT++++T+++--
-----+-+T++T--------
++++-+-+P+++-+++T+++
++++-+-+++---T++++++
++---T-+F+-+++++++++
+T-+++-T+--T++++++++
X------T+X++++++++++