1
F++++++++X++++++++++
+++++++++-++++++++++
++++++T++-++++++++++
+++++++++--+T+++++++
++++++++++---+++++++
++++++++++++-+++++++
+++++++++T++-+++++++
++++++++++++-+++++++
++++++++++++-+++++++
++++++++-----+++++++
++++++++-+++T+++++++
++++++++-M++++++++++