1
+++++++++++++++++++X
++++++++++++++++++--
++++++++++++++++++-+
++++++++++++++++T+-T
++++++++++++++++++-+
++++++++++++++++++-T
++++++++F++++------+
+++++++++++++-++T+++
+++++++++++++-++T+++
+++++++++++++-------
+++T+++T++T+++++TP+-
X------------------M